{
    "map" : [
    [8,8,8,8,8,8,8,8,8,8,8,8,8,8,8,8,8,8,8,8,8,8,8,8],
    [8,0,0,0,0,0,0,0,0,0,8,4,0,0,0,0,0,0,0,0,0,0,0,8],
    [8,0,3,3,0,0,0,0,0,8,8,4,0,0,0,0,0,0,0,0,0,0,0,8],
    [8,0,0,3,0,0,0,0,0,0,0,0,0,0,0,0,0,0,0,0,0,0,0,8],
    [8,0,3,3,0,0,0,0,0,8,8,4,0,0,0,0,0,0,0,0,0,0,0,8],
    [8,0,0,0,0,0,0,0,0,0,8,4,0,0,0,0,0,6,6,6,0,6,4,8],
    [8,8,8,8,0,8,8,8,8,8,8,4,4,4,4,4,4,6,0,0,0,0,0,8],
    [8,7,7,7,0,7,7,7,7,0,8,0,8,0,8,0,8,4,0,4,0,6,0,8],
    [8,7,0,0,0,0,0,0,7,8,0,8,0,8,0,8,8,6,0,0,0,0,0,8],
    [8,0,0,0,0,0,0,0,0,0,0,0,0,0,0,0,8,6,0,0,0,0,0,8],
    [8,0,0,0,0,0,0,0,0,0,0,0,0,0,0,0,8,6,0,6,0,6,0,8],
    [8,7,0,0,0,0,0,0,7,8,0,8,0,8,0,8,8,6,4,6,0,6,6,8],
    [8,7,7,7,0,7,7,7,7,8,8,4,2,6,8,4,8,3,3,3,0,3,3,8],
    [8,2,2,2,0,2,2,2,2,4,0,0,0,0,0,0,6,3,0,0,0,0,0,8],
    [8,2,0,0,0,0,0,2,2,0,0,0,0,0,0,0,4,3,0,0,0,0,0,8],
    [8,0,0,0,0,0,0,0,2,0,0,0,0,0,0,0,4,3,0,0,0,0,0,8],
    [8,0,0,0,0,0,0,0,1,4,0,0,0,0,0,0,6,3,3,0,0,0,3,8],
    [8,0,0,0,0,0,0,0,2,2,2,1,2,2,2,6,6,0,0,5,0,5,0,8],
    [8,2,0,0,0,0,0,2,2,2,0,0,0,2,2,0,5,0,5,0,0,0,5,8],
    [8,0,0,0,0,0,0,0,2,0,0,0,0,0,2,5,0,5,0,5,0,5,0,8],
    [8,0,0,0,0,0,0,0,0,0,0,0,0,0,0,0,0,0,0,0,0,0,0,8],
    [8,0,0,0,0,0,0,0,2,0,0,0,0,0,2,5,0,5,0,5,0,5,0,8],
    [8,2,0,0,0,0,0,2,2,2,0,0,0,2,2,0,5,0,5,0,0,0,5,8],
    [8,8,8,8,8,8,8,8,8,8,8,8,8,8,8,8,8,8,8,8,8,8,8,8]
    ],

    "posX" : 20,
    "posY" : 11,
    "dirX" : -1,
    "dirY" : 0,
    // These should be moved to a player settings file
    "rotFactor" : 3,
    "moveFactor" : 2,
    "cpuwait" : 5
}
